1111111111111
1001000000001
1000010000E01
1PPC011111111
11111