111111111
101000C01
10P110001
10C001E01
100000101
111111111
