111111111
100001C11
10P000101
10C000E01
100000001
111111111
