111111111
100100C01
10P010001
10C100E01
101010001
111111111