111111111
100000C01
10P000101
10C001E11
100000101
111111111
