111111111
100001C01
10P010001
10C000E01
100110001
111111111
