1111111111111
100100E001111
10000100001
1PC0111111111
1111111111111