1111111
100100E1
100001001
1PC0111111
11111111111