111111111
100100E001
10000100001
1PC011111111
1111111111111